timestamp,market_id,race_name,track,date,leg,selection,odds,stake,result,profit,balance
2025-09-01T16:19:00.951537+01:00,1.247237991,7f Stks,Roscommon 1st Sep,2025-09-01 15:12:00+00:00,1,Summer Is Tomorrow,3.05,8.8,W,18.04,238.04
2025-09-01T16:38:31.291564+01:00,1.247234989,6f Nursery,Windsor 1st Sep,2025-09-01 15:30:00+00:00,1,Flying Comet,2.14,9.53,W,10.8642,248.9042
2025-09-01T16:50:00.695959+01:00,1.247237996,7f Hcap,Roscommon 1st Sep,2025-09-01 15:45:00+00:00,1,Purring Along,6.4,9.96,L,-9.96,238.9442
2025-09-01T17:06:30.947692+01:00,1.247234996,6f Nov Stks,Windsor 1st Sep,2025-09-01 16:00:00+00:00,2,Lodge,1.94,12.72,L,-12.72,226.2242
2025-09-01T17:23:31.077047+01:00,1.247238001,7f Hcap,Roscommon 1st Sep,2025-09-01 16:15:00+00:00,3,Rowdy Yeats,5.4,19.08,L,-19.08,207.1442
2025-09-01T17:37:01.039934+01:00,1.247235003,1m Nov Stks,Windsor 1st Sep,2025-09-01 16:30:00+00:00,4,Lavender Gold,3.5,28.62,L,-28.62,178.5242
2025-09-01T18:09:02.739891+01:00,1.247238006,1m2f Stks,Roscommon 1st Sep,2025-09-01 16:45:00+00:00,5,In My Teens,2.48,47.23,L,-47.23,131.29420000000002
2025-09-01T18:23:31.051301+01:00,1.247238011,1m4f Mdn,Roscommon 1st Sep,2025-09-01 17:15:00+00:00,6,Indian River,3.65,131.29420000000002,L,-131.29420000000002,0.0
