timestamp,market_id,race_name,track,date,leg,selection,odds,stake,result,profit,balance
2025-09-02T13:41:00.855437+01:00,1.247279563,7f Mdn,Gowran Park 2nd Sep,2025-09-02 12:35:00+00:00,1,Minerva,1.84,8.8,L,-8.8,211.2
2025-09-02T14:03:31.835023+01:00,1.247278433,1m Mdn Stks,Goodwood 2nd Sep,2025-09-02 12:48:00+00:00,2,I Can Dance,2.18,8.95,L,-8.95,202.25
2025-09-02T14:17:00.884427+01:00,1.247279568,7f Mdn,Gowran Park 2nd Sep,2025-09-02 13:10:00+00:00,3,Charles Fort,3.25,13.43,L,-13.43,188.82
2025-09-02T14:32:01.158727+01:00,1.247278476,6f Nursery,Goodwood 2nd Sep,2025-09-02 13:23:00+00:00,4,Anaisa,2.42,22.16,L,-22.16,166.66
2025-09-02T14:57:01.444091+01:00,1.247279573,7f Mdn,Gowran Park 2nd Sep,2025-09-02 13:45:00+00:00,5,Diego El Queso,2.98,36.57,L,-36.57,130.09
2025-09-02T15:29:32.279511+01:00,1.247279578,7f Hcap,Gowran Park 2nd Sep,2025-09-02 14:20:00+00:00,6,Washington Street,3.5,130.09,L,-130.09,0.0
